111111
111001
1000e1
100m11
111111