1111111
1e00001
1110111
1000001
100m001
1111111